########
#000000#
#000000#
#000900#
#000000#
#000000#
#000000#
########